--o-----o--
---o---o---
--ooooooo--
-oo-ooo-oo-
ooooooooooo
o-ooooooo-o
o-o-----o-o
---oo-oo---
------oo---
-----oooo--
----oo-ooo-
----o-oo-oo
---oooooooo
-----o--o--
----o-o--o-
---o-o--o-o