--------------
-o-----o------
--o---o-------
-ooooooo------
oo-ooo-oo-----
oooooo-ooo----
-ooooooo-o----
-o-----o-o----
--oo-oo-------